#######@
#.......
#.#.&13.
#.#.4S..
#.#.&245
#.......
####.##.
......#.
.####.#.
E#......
