########
#.......
#.#.###.
#.#.#S..
#.#.####
#.......
####.##.
......#.
E#......
