########
#.......
#.#.###.
#.#.#S..
#.#.####
#.......
####.##.
......#.
.####.#.
E#......
